2021-05-23 Boatshed
Dreams - Fleetwood Mac
Seven Nation Army
are you gonna go my way
Superstition
Gold Dust Woman - Fleetwood Mac
The Chain - Fleetwood Mac
Ive Got You On My Mind - Powderfinger
Sex on Fire - Kings Of Leon
never tear us apart - inxs
Valerie
Bring Me Some Water - Melissa Etheridge
Passionfruit - Drake
Dont Start Now - Dua Lipa
Groove Is In The Heart - Deee-Lite
Smoke On the Water - Deep Purple
Whole Lotta Love - Led Zepplin
Higher Ground
Always On The Run - Lenny Kravitz
Love Shack - The B-52's
Rebel Yell - Billy idol
Long Train Running - Doobie Brothers
Nutbush
Killing In The Name Of
----------PARKED SONGS----------
Rush You
Blister In The Sun
Pleasure and Pain
Chasing Cars - Snow Patrol
Summer of '69 - Bryan Adams
Come Together - Beatles
Lonely Boy
500 Miles - The Proclaimers
Another Brick In The Wall - Pink Floyd
April Sun In Cuba - Dragon
Boys In Town
Cry In Shame - Diesel
Faith - George Michael
Hard to Handle
Hit Me With Your Best Shot
Sympathy and Entertain You - Rolling Stones & Robbie Williams
Hush
I Got A Feeling - Black-Eyed Peas
Love Rears Its Ugly Head - Living Colour
My Hero - Foo Fighters
One - U2
Purple Haze - Jimi Hendrix
Rhiannon - Fleetwood Mac
Smells Like Teen Spirit - Nirvana
Wonderwall
Uptown Funk - Bruno Mars
Wanted Dead Or Alive
White Wedding - Billy Idol
