Alternatives (1)
AIN'T NO SUNSHINE
All About That Bass - Meghan Trainor
Another Brick In The Wall - Pink Floyd
April Sun In Cuba - Dragon
Babe I'm Gonna Leave You Pink-Mojo Version - Led Zepplin
Blister In The Sun
Boys In Town
Brass In Pocket - The Pretenders
Deer Stand
Do You See What I See
Don't Tear It Down
exs and ohs - Elle King
Faith - George Michael
Hit Me With Your Best Shot - Pat Benatar
I Got A Feeling - Black-Eyed Peas
Is This Love - Bob Marley
Ive Got You On My Mind - Powderfinger
Lonely Boy
Love Rears Its Ugly Head - Living Colour
Mamma Mia - Abba
Money - Pink Floyd
Mr Brightside - The Killers
Nutbush
Never Gonna Give You Up - Rick Astley
Play That Funky Music - Wild Cherry
Pleasure and Pain
Proud Mary - Creedence Clearwater Revival
Rush You
Roxanne - The Police
Sex on Fire - Kings Of Leon
Seven Nation Army
Save Tonight - Eagle Eye Cherry
Smells Like Teen Spirit - Nirvana
Smoke On the Water - Deep Purple
Stayin'[A]live - The Bee Gees
Summer of '69 - Bryan Adams
Sweet Caroline - Neil Diamond
Sympathy and Entertain You - Rolling Stones & Robbie Williams
Teenage Dirtbag - Wheatus
Tribute - Tenacious [D]
Valerie
Wanted Dead Or Alive
Who Knew - Pink
Whole Lotta Love - Led Zepplin
Better
