Chris Acoustic
AIN'T NO SUNSHINE
Babe I'm Gonna Leave You - Led Zepplin
Black And Gold - Sam Sparro
Call Me The Breeze
Chasing Cars - Snow Patrol
Deer Stand
Enter The Sandman - Metallica
Everlong
Killing In The Name Of
Landslide - Fleetwood Mac
Light My Fire - Doors
Lonely Boy
Love Shack - The B-52's
Melt With You
Man In A Box - Alice in Chains
My Hero - Foo Fighters
never tear us apart - inxs
Nothing Else Matters - Metallica
One - U2
Poker Face - Lady GaGa
Price Tag - Jessie J
Purple Haze - Jimi Hendrix
Rebel Yell - Billy idol
Save Tonight - Eagle Eye Cherry
Seven Nation Army
Sex on fire - Kings Of Leon
Smoke On the Water - Deep Purple
Stocking Song - Steel Panther
Tribute - Tenacious [D]
Under The Milky Way - Church
Wanted Dead Or Alive
Whip It - Devo
White Wedding - Billy Idol
Would
Wrecking Ball - Miley Cyrus
Zombie - The Cranberries
Randy - Manilow & Tex
Randy 2 - Tex & Manilow
Is This Love - Bob Marley
