Old 2021-07-14 Buckettys
----------SOUND CHECK----------
April Sun In Cuba - Dragon
----------NEW SONGS----------
Cant Feel My Face - The Weeknd
London Calling - The Clash
Town Called Malice - The Jam
Should I Stay Or Should I Go Now - The Clash
Mamma Mia - Abba
Another Brick In The Wall - Pink Floyd
Comfortably Numb - Pink Floyd
----------FIRST SET----------
Dreams - Fleetwood Mac
Yellow - Coldplay
Faith - George Michael
are you gonna go my way
Ive Got You On My Mind - Powderfinger
never tear us apart - inxs
Passionfruit - Drake
The Chain - Fleetwood Mac
Bring Me Some Water - Melissa Etheridge
Chasing Cars - Snow Patrol
Wanted Dead Or Alive
Valerie
Groove Is In The Heart - Deee-Lite
Long Train Running - Doobie Brothers
Smoke On the Water - Deep Purple
----------SECOND SET----------
Mercy - Duffy
Gold Dust Woman - Fleetwood Mac
Seven Nation Army
Dont Start Now - Dua Lipa
Watermelon Sugar - Harry Stiles
Sex on Fire - Kings Of Leon
Always On The Run - Lenny Kravitz
One - U2
Superstition
Lady - Modjo
Love Shack - The B-52's
Nutbush
Boys In Town
Enter The Sandman - Metallica
Rebel Yell - Billy idol
----------THIRD SET----------
Come Together - Beatles
Blister In The Sun
Rhiannon - Fleetwood Mac
Love Rears Its Ugly Head - Living Colour
Is This Love - Bob Marley
Brass In Pocket - The Pretenders
I Got A Feeling - Black-Eyed Peas
Mr Brightside - The Killers
Proud Mary - Creedence Clearwater Revival
Pleasure and Pain
Smells Like Teen Spirit - Nirvana
Whole Lotta Love - Led Zepplin
My Hero - Foo Fighters
Rush You
Higher Ground
Slither - Velvet Revolver
Am I Ever Gonna See Your Face Again - Angels
Killing In The Name Of
----------PARKED SONGS----------
Movin On Up - Primal Scream
Summer of '69 - Bryan Adams
Lonely Boy
Echo Beach - Martha And The Muffins
Cry In Shame - Diesel
Hard to Handle
Hit Me With Your Best Shot
Sympathy and Entertain You - Rolling Stones & Robbie Williams
Hush
Uptown Funk - Bruno Mars
White Wedding - Billy Idol
Play That Funky Music - Wild Cherry
